11x31
*******************************
*   R                         *
*                     H       *
*  R    *             *       *
*     *    R            *     *
*   *     ***********     *   *
*     *                 *     *
*       *             *     R *
*                             *
*           R                 *
*******************************