11x31
*******************************
*       R                     *
*                             *
*       *             *       *
*     *                 *     *
*   *     ***********     *   *
*     *     R    R      *     *
*   R   *             *       *
*                  H          *
*       R                     *
*******************************