13x29
*****************************
*       R                   *
* R   **            ** H    *
*       **        **        *
*        * *    * *         *
*        *        *      R  *
*        * R      *         *
*                    R      *
*                           *
*         ********          *
*      **          **       *
*                           *
*****************************