11x31
*******************************
*      H                      *
*                             *
*       *             *    R  *
* R   *     R           *     *
*   *     ***********     *   *
*     *                 *     *
*       *   R         *       *
*                  R          *
*                             *
*******************************