10 x 25
*************************
*       H               *
* R  *   *     *   *    *
*   *     *   *     *   *
*    *       R     *    *
*      R                *
*       *   R   *       *
*         *   *         *
*           *           *
*************************