14 x 32
****O*O*O**************O*O*O****
*  R  R  R                  R  *
*    +++                +++    *
*R   +   +R           + R +    *
*    +    +          +    + R  *
*                              *
*        R   *    *           R*
*            *    *            *
*                          R   *
*     +++       H      +++     *
* R          *    *            *
*        R    ****   R  R   R  *
*  R      R  R      R       R  *
********************************