13x29
*****************************
*                           *
*     **            **   R  *
*   H   **      R **        *
*        * *    * *         *
*        *        *         *
*        *        *         *
*     R                     *
*         R                 *
*         ********          *
*      **          **       *
*  R                        *
*****************************