12 x 26 
**************************
*                     R  *
*     *  ++++++++  *     *
*              H         *
*     +            +     *
*     +     **     +    R*
*     +     **     +     *
O R   +        R   +     O
*       R       R        *
*     *  ++++++++  *     *
*                      R *
***********O**O***********