11x31
*******************************
*                         R   *
*                             *
*       *             *       *
*     *              R  *     *
*   *   H ***********     *   *
*     *          R      *     *
*       *             *       *
*              R              *
*          R                  *
*******************************