********************
*   R         R    *
*    R  * * *      *
*          H *     *
*   **      *  *   *
*   *       * *    *
*     * *     R *  *
*  *            ** *
*      R       *   *
********************