12 x 26 
**************************
*                     R  *
*     *  ++++++++  *     *
*                        *
*     +            +     *
*     +     **     +     *
*     +     **     +    R*
O R   +        R   +    HO
*       R       R        *
*     *  ++++++++  *     *
*                      R *
***********O**O***********