10 x 25
*************************
*                       *
*       *       *       *
*       *       *       *
*   R                   *
*                       *
*       * R     *       *
*         *****    H    *
*         R             *
*************************