14 x 29 
*****************************
*             H             *
*       *           *       *
*         *       *         *
*         + *   * +   R     *
*         + R     +         *
*      R  +    R  +         *
*   R     +       +         *
*             +R            *
*  R                        *
*          *******    R     *
*        **       **     R  *
* R   R       R       R     *
****O****O****O****O****O****