10 x 20
********************
*                  *
*     ** ** R      *
*     *            *
*     *     *      *
*                  *
*    R  ** * * *   *
*   *        H     *
*    R             *
********************