10 x 25
*************************
*                       *
*    *   *     *   *    *
*   *     *   *     *   *
*    *  R          *    *
*                   H   *
*       *  R    *       *
*         *   *         *
*           *   R   R   *
*************************