10 x 20
********************
*     R            *
*     **H**        *
*     *            *
*     *     *      *
*    R             *
*       ** * * *   *
*   *     R        *
*                  *
********************