13x29
*****************************
*   R                    R  *
*     **            **      *
*       **        **        *
*        * *    * *         *
*        *        *         *
*        *        *    R    *
*                           *
*                           *
*         ********          *
*      **      R   **       *
*    H                  R   *
*****************************