10 x 20
********************
*                  *
*     ** **        *
*   H *            *
*     *     *  R   *
* R                *
*       ** * * *   *
*   *              *
*     R            *
********************