11x31
*******************************
*            R                *
*                             *
*       *             *       *
*     *             R   *     *
*   *     ***********     *   *
*     *           R     *     *
*   H   *             *       *
*                             *
*          R        R         *
*******************************