10 x 25
*************************
*                       *
*    *   *     *   *    *
*   *     *   *     *   *
*    *      R      *    *
*  R                    *
*       *  R     *      *
*    R    *   *  H      *
*           *           *
*************************