13x29
*****************************
*            H              *
*     **            **   R  *
*       **        **        *
*        * *    * *       R *
*        *        *         *
*        *        *         *
*            R              *
*                           *
*  R      ********          *
*      **          **     R *
*                           *
*****************************